    NO ./textures/lava.xpm


     WE         ./textures/leaves.xpm
EA     ./textures/stone.xpm           

SO            ./textures/water.xpm
F 220,100,0
             

    C 225,30,0
    
    
    

    1111111111111111111111111111111111111111    
    1100000000000000000000000000000000001  1
    1 11111111111111111000000000000000001  1   
    1  1111111111000000000000000000011111  1
    1   100000000000000000000000000111     1     
    1  10000000000000000000S00001111111    1
    1   11100000000000000000000000001      1     1
    1     110000000000000000000000001      1   
    1     11000000000000000000001111       1
    1111111111111111111111111111111111111111    




