    NO ./textures/lava.xpm


     WE         ./textures/leaves.xpm
EA     ./textures/stone.xpm           

SO            ./textures/water.xpm
F 220   ,      100,0
C 225    ,30  ,    0112
111111111111111111111111111111111111111111111111111111111111111111111111
100000000000000000000000000000000000000000000000000000000000000000000001
100000000000000000000000000000000000000000000000000000000000000000000001
100000000000000000000000000000000000000000000000000000000000000000000001
100000000000000000000000000000000000000000000000000000000000000000000001
100000000000000000000000000000000000000000000000000000000000000000000001
10000000S000000000000000000000000000000000000000011111000000000000000001
100000000000000000000000000000000000000000000000011111000000000000000001
100000000000000000000000000000000000000000000000011111000000000000000001
100000000000000000000000000000000000000000000000000000000000000000000001
100000000000000000000000000000000000000000000000000000000000000000000001
100000000000000000000000000000000000000000000000000000000000000000000001
100000000000000000000000000000000000000000000000000000000000000000000001
100000000000000000000000000000000000000000000000000000000000000000000001
100000000000000000000000000011111111110000000000000000000000000000000001
100000000000000000000000000011111111110000000000000000000000000000000001
100000000000000000000000000011111111110000000000011111111111111110000001
100000000000000000000000000000000000000000000000011111111111111110000001
100000000000000000000000000000000000000000000000011111111111111110000001
100000000000000000000000000000000000000000000000011111111111111110000001
100000000000000000000000000000000000000000000000011111111111111110000001
100000000000000000000000000000000000000000000000011111111111111110000001
100000000000000000000000000000000000000000000000011111111111111110000001
100000000000000000000000000000000000000000000000011111111111111110000001
100000000000000000000000000000000000000000000000000000000000000000000001
100000000000000000000000000000000000000000000000000000000000000000000001
100000000000000000000000000000000000000000000000000000000000000000000001
111111111111111111111111111111111111111111111111111111111111111111111111