
NO bla
WE         ./path_to_the_west_texture
EA     ./path_to_the_east_texture            

SO            ./path_to_the_south_texture
F 220,100,0
             

    C 225,30,0
    
    
    C

   
   
11111
10001
11111
    11111111
11111N0011
111111111
