
NO bla
WE         ./path_to_the_west_texture
EA     ./path_to_the_east_texture            

SO            ./path_to_the_south_texture
F 220,100,0
             

    C 225,30,0


          1
          1
          1
          1111111111111111111
    111111100000000000000000111111
    10000000000000000000000000001111
    111111111111111111111111111111
                1