
NO bla
WE         ./path_to_the_west_texture
EA     ./path_to_the_east_texture            

SO            ./path_to_the_south_texture
F 220,100,0
             

    C 225,30,0
    
    
    

    1111111111111111111111111111111111111111
    1100000000000000000000000000000000001 1
    1 11111111111111111000000000000000001  1
    1  111111111100000000000000000001111   1
    1   100000000W000000000000000000111    1
    1    1000000000000000000000000001     1
    1     100000000000000000000000001      1
    1      10000000000000000000000001      1
    1      1000000000000000000001111       1
    1111111111111111111111111111111111111111




