
    NO bla


     WE         ./path_to_the_west_texture
EA     ./path_to_the_east_texture            

SO            ./path_to_the_south_texture
F 220,100,0


    C 225,30,0


   



    11111111
1111100011
111111111
